NO textures/cub3d_tex/hive_h.xpm
SO textures/cub3d_tex/hive_i.xpm
WE textures/cub3d_tex/hive_v.xpm
EA textures/cub3d_tex/hive_e.xpm

F 20,20,150
C 200,0,200

111111111111111111111111111111111
100000100000000001000000000000001
100000100000000001000000000010001
100000100000000001000000000010001
110011111110011111111110011110001
100000000000000000000000000010001
100000000000000000000000000000001
10000011111110011111111110W111111
100000100000000000000010000010001
100000100000000000000010000010001
100000111111111111111110000010001
100000100000000000000010000010001
100000111100011111111110000011111
100000000000000000000010000000001
100000000000000000000000000010001
111111111111111111111111111111111