NO texture_src/brick_1_moss.xpm
SO texture_src/brick_1.xpm
WE texture_src/brick_2.xpm
EA texture_src/brick_1.xpm

F 20,20,150
C 200,0,200

111111111111111111111111111111111111111111111111111111111111111111111111111111111111111111111111111111111111111111111111111111111111111111111111111111111111111111111111111111111111111111111111111111111111
1 0000000000000 00000 000000000000000000000000 00000 000000000000000000000000 00000 000000000000000000000000 00000 000000000000000000000000 00000 000000000000000000000000 00000 000000000000000000000000 01
1010010100100000101001000000010100000000000000 00000 000000000000000000000000 00000 000000000000000000000000 00000 000000000000000000000000 00000 000000000000000000000000 00000 000000000000000000000000 01
100000000000000 00000 000000000000000000000000 00000 000000000000000000000000 00000 000000000000000000000000 00000 000000000000000000000000 00000 000000000000000000000000 00000 000000000000000000000000 01
1010010100100000101001000000010100000000000000 00000 000000000000000000000000 00000 000000000000000000000000 00000 000000000000000000000000 00000 000000000000000000000000 00000 000000000000000000000000 01
1010010010101010001001000000010100000000000000 00000 000000000000000000000000 00000 000000000000000000000000 00000 000000000000000000000000 00000 000000000000000000000000 00000 000000000000000000000000 01
100000000000000 00000 000000000000000000000000 00000 000000000000000000000000 00000 000000000000000000000000 00000 000000000000000000000000 00000 000000000000000000000000 00000 000000000000000000000000 01
1010010100100000101001000000010100000000000000 00000 000000000000000000000000 00000 000000000000000000000000 00000 000000000000000000000000 00000 000000000000000000000000 00000 000000000000000000000000 01
1010010010101010001001000000010100000000000000 00000 000000000000000000000000 00000 000000000000000000000000 00000 000000000000000000000000 00000 000000000000000000000000 00000 000000000000000000000000 01
100000000000000 00000 000000000000000000000000 00000 000000000000000000000000 00000 000000000000000000000000 00000 000000000000000000000000 00000 000000000000000000000000 00000 000000000000000000000000 01
1010010100100000101001000000010100000000000000 00000 000000000000000000000000 00000 000000000000000000000000 00000 000000000000000000000000 00000 000000000000000000000000 00000 000000000000000000000000 01
100000000000000 00000 000000000000000000000000 00000 000000000000000000000000 00000 000000000000000000000000 00000 000000000000000000000000 00000 000000000000000000000000 00000 000000000000000000000000 01
1010010100100000101001000000010100000000000000 00000 000000000000000000000000 00000 000000000000000000000000 00000 000000000000000000000000 00000 000000000000000000000000 00000 000000000000000000000000 01
1010010010101010001001000000010100000000000000 00000 000000000000000000000000 00000 000000000000000000000000 00000 000000000000000000000000 00000 000000000000000000000000 00000 000000000000000000000000 01
100000000000000 00000 000000000000000000000000 00000 000000000000000000000000 00000 000000000000000000000000 00000 000000000000000000000000 00000 000000000000000000000000 00000 000000000000000000000000 01
1010010100100000101001000000010100000000000000 00000 000000000000000000000000 00000 000000000000000000000000 00000 000000000000000000000000 00000 000000000000000000000000 00000 000000000000000000000000 01
1010010010101010001001000000010100000000000000 00000 000000000000000000000000 00000 000000000000000000000000 00000 000000000000000000000000 00000 000000000000000000000000 00000 000000000000000000000000 01
100000000000000 00000 000000000000000000000000 00000 000000000000000000000000 00000 000000000000000000000000 00000 000000000000000000000000 00000 000000000000000000000000 00000 000000000000000000000000 01
1010010100100000101001000000010100000000000000 00000 000000000000000000000000 00000 000000000000000000000000 00000 000000000000000000000000 00000 000000000000000000000000 00000 000000000000000000000000 01
1010010010101010001001000000010100000000000000 00000 000000000000000000000000 00000 000000000000000000000000 00000 000000000000000000000000 00000 000000000000000000000000 00000 000000000000000000000000 01
100000000000000 00000 000000000000000000000000 00000 000000000000000000000000 00000 000000000000000000000000 00000 000000000000000000000000 00000 000000000000000000000000 00000 000000000000000000000000 01
1010010100100000101001000000010100000000000000 00000 000000000000000000000000 00000 000000000000000000000000 00000 000000000000000000000000 00000 000000000000000000000000 00000 000000000000000000000000 01
1010010010101010001001000000010100000000000000 00000 000000000000000000000000 00000 000000000000000000000000 00000 000000000000000000000000 00000 000000000000000000000000 00000 000000000000000000000000 01
100000000000000 00000 000000000000000000000000 00000 000000000000000000000000 00000 000000000000000000000000 00000 000000000000000000000000 00000 000000000000000000000000 00000 000000000000000000000000 01
1010010100100000101001000000010100000000000000 00000 000000000000000000000000 00000 000000000000000000000000 00000 000000000000000000000000 00000 000000000000000000000000 00000 000000000000000000000000 01
1010010010101010001001000000010100000000000000 00000 000000000000000000000000 00000 000000000000000000000000 00000 000000000000000000000000 00000 000000000000000000000000 00000 000000000000000000000000 01
100000000000000 00000 000000000000000000000000 00000 000000000000000000000000 00000 000000000000000000000000 00000 000000000000000000000000 00000 000000000000000000000000 00000 000000000000000000000000 01
1010010100100000101001000000010100000000000000 00000 000000000000000000000000 00000 000000000000000000000000 00000 000000000000000000000000 00000 000000000000000000000000 00000 000000000000000000000000 01
1010010010101010001001000000010100000000000000 00000 000000000000000000000000 00000 000000000000000000000000 00000 000000000000000000000000 00000 000000000000000000000000 00000 000000000000000000000000 01
100000000000000 00000 000000000000000000000000 00000 000000000000000000000000 00000 000000000000000000000000 00000 000000000000000000000000 00000 000000000000000000000000 00000 000000000000000000000000 01
1010010100100000101001000000010100000000000000 00000 000000000000000000000000 00000 000000000000000000000000 00000 000000000000000000000000 00000 000000000000000000000000 00000 000000000000000000000000 01
1010010010101010001001000000010100000000000000 00000 000000000000000000000000 00000 000000000000000000000000 00000 000000000000000000000000 00000 000000000000000000000000 00000 000000000000000000000000 01
100000000000000 00000 000000000000000000000000 00000 000000000000000000000000 00000 000000000000000000000000 00000 000000000000000000000000 00000 000000000000000000000000 00000 000000000000000000000000 01
1010010100100000101001000000010100000000000000 00000 000000000000000000000000 00000 000000000000000000000000 00000 000000000000000000000000 00000 000000000000000000000000 00000 000000000000000000000000 01
1010010010101010001001000000010100000000000000 00000 000000000000000000000000 00000 000000000000000000000000 00000 000000000000000000000000 00000 000000000000000000000000 00000 000000000000000000000000 01
100000000000000 00000 000000000000000000000000 00000 000000000000000000000000 00000 000000000000000000000000 00000 000000000000000000000000 00000 000000000000000000000000 00000 000000000000000000000000 01
1010010100100000101001000000010100000000000000 00000 000000000000000000000000 00000 000000000000000000000000 00000 000000000000000000000000 00000 000000000000000000000000 00000 000000000000000000000000 01
1010010010101010001001000000010100000000000000 00000 000000000000000000000000 00000 000000000000000000000000 00000 000000000000000000000000 00000 000000000000000000000000 00000 000000000000000000000000 01
100000000000000 00000 000000000000000000000000 00000 000000000000000000000000 00000 000000000000000000000000 00000 000000000000000000000000 00000 000000000000000000000000 00000 000000000000000000000000 01
1010010100100000101001000000010100000000000000 00000 000000000000000000000000 00000 000000000000000000000000 00000 000000000000000000000000 00000 000000000000000000000000 00000 000000000000000000000000 01
1010010010101010001001000000010100000000000000 00000 000000000000000000000000 00000 000000000000000000000000 00000 000000000000000000000000 00000 000000000000000000000000 00000 000000000000000000000000 01
100000000000000 00000 000000000000000000000000 00000 000000000000000000000000 00000 000000000000000000000000 00000 000000000000000000000000 00000 000000000000000000000000 00000 000000000000000000000000 01
1010010100100000101001000000010100000000000000 00000 000000000000000000000000 00000 000000000000000000000000 00000 000000000000000000000000 00000 000000000000000000000000 00000 000000000000000000000000 01
1010010010101010001001000000010100000000000000 00000 000000000000000000000000 00000 000000000000000000000000 00000 000000000000000000000000 00000 000000000000000000000000 00000 000000000000000000000000 01
100000000000000 00000 000000000000000000000000 00000 000000000000000000000000 00000 000000000000000000000000 00000 000000000000000000000000 00000 000000000000000000000000 00000 000000000000000000000000 01
1010010100100000101001000000010100000000000000 00000 000000000000000000000000 00000 000000000000000000000000 00000 000000000000000000000000 00000 000000000000000000000000 00000 000000000000000000000000 01
1010010010101010001001000000010100000000000000 00000 000000000000000000000000 00000 000000000000000000000000 00000 000000000000000000000000 00000 000000000000000000000000 00000 000000000000000000000000 01
1010010010101010001001000000010100000000000000 00000 000000000000000000000000 00000 000000000000000000000000 00000 000000000000000000000000 00000 000000000000000000000000 00000 000000000000000000000010 01
1010010010101010001001000000010100000000000000 00000 000000000000000000000000 00000 000000000000000000000000 00000 000000000000000000000000 00000 000000000000000000000000 00000 000000000000000000000001 01
100000000 00 0000 00000000000000 0000000000000 00000 000000000000000000000000 00000 000000000000000000000000 00000 000000000000000000000000 00000 000000000000000000000000 00000 000000000000000000000000 N1
111111111111111111111111111111111111111111111111111111111111111111111111111111111111111111111111111111111111111111111111111111111111111111111111111111111111111111111111111111111111111111111111111111111111