NO textures/test/north.xpm
SO textures/test/south.xpm
WE textures/test/west.xpm
EA textures/test/east.xpm

F 20,20,20
C 200,200,20

11111
10 01
1 S 1
10 01
10001
10001
11001
10001
10001
10001
10001
10001
11111
