NO textures/simonkraft/wet_sponge.xpm
SO textures/simonkraft/wet_sponge.xpm
WE textures/simonkraft/wet_sponge.xpm
EA textures/simonkraft/wet_sponge.xpm

F 164,169,21
C 153,214,255

111111111111111111111
111111111111111111111
111111111111111111111
111111111111111111111
111111111111111111111
111111111111111111111
111111111111111111111
111111111111111111111
111111111111111111111
111111111111111111111
111111111111111111111
111111111111111111111
111111111111111111111
111111111111111111111
111111111111111111111
111111111111111111111
111111111111111111111
111111111111111111111
111111111111111111111
1N1111111111111111111
111111111111111111111

                           
                            