NO textures/test/north.xpmSO textures/test/south.xpmWE textures/test/west.xpmEA textures/test/east.xpmF 20,   26, 1C 200,200,200
111111000110S0110001100011000111001100011000110001100011000111111