NO textures/wolfenstein/grey_stone.xpm
  
SO textures/wolfenstein/purple_stone.xpm

WE textures/wolfenstein/red_brick.xpm 
   
EA textures/wolfenstein/wood.xpm
                                
                                
F 220,100,0
C 225,30,0






            
1111        1111111111111111111111111          
10 1        1000000000110000000000001
1001        1011000001110000000000001
1111        1001000000000000000000001
   1111111111111111111111111
111111111011000001110000011111111111111111111111111
111111111011000001110000000000001
100000000011000001110111111111111
11110111111111011100000010001
11110111111111011101010010001
11000000110101011100000010001
10000000000000001100000010001
10000000000000001101010010001
11000001110101011111011110N0111
11110111 1110101 101111010001
11111111 1111111 111111111111
           
