NO texture_src/brick_1_moss.xpm
SO texture_src/brick_1.xpm
WE texture_src/brick_2.xpm
EA texture_src/brick_1.xpm

DO texture_src/cat_tree.xpm

F texture_src/gree.xpm
C 200,0,200

11111111
1E00D011
10001011
11111111