NO texture_src/cube.xpm
SO texture_src/jen.xpm
WE texture_src/cat.xpm
EA texture_src/linh.xpm

DO texture_src/rainbow_door.xpm

F texture_src/floor1.xpm
C texture_src/night_1.xpm
C texture_src/night_2.xpm
C texture_src/night_3.xpm

11111111
1E00D011
10001011
11111D11111111111
10000000000000001
10000000000000001
10000000000000001
10000000000000001
10000000000000001
10000000000000001
10000000000000001
10000000000000001
10000000000000001
11111111111111111
