NO texture_src/cat_tree.xpm
SO texture_src/robo_cat.xpm
WE texture_src/cat_shelf.xpm
EA texture_src/grey_cat.xpm

DO texture_src/cat_door.xpm

F texture_src/floor2.xpm
C texture_src/sky_1.xpm
C texture_src/sky_2.xpm
C texture_src/sky_3.xpm

       111         111
      11011       11011
      10001       10001
    1111D11111111111D1111
   11000000000000000000011
  1100000000000000000000011
11100000000000000000000000111
10000111111000000011111100001
10000001100000000000110000001
10000000000000N00000000000001
10000000000111111000000000001
111000000000100D0000000000111
  1100000000011000000000011
   11100000000000000000111
     1111111111111111111
