NO textures/cub3d_tex/hive_h.xpm
SO textures/cub3d_tex/hive_i.xpm
WE textures/cub3d_tex/hive_v.xpm
EA textures/cub3d_tex/hive_e.xpm

F 20,20,20
C 200,200,200

111111111111111111111111111111111111111111111111111111111
1			1				 1							1
1			1				 1					1		1
1			1				 1					1		1
1			1				 1					1		1
1			1				 1  				1		1
1			1				 1					1		1
111    1111111111111    11111111111111    1111111		1
1												1		1
1														1
1														1
1			1111111111    11111111111111	1111111111111
1			1						 1			1		1
1			1						 1			1		1
1			11111111111111111111111111			1		1
1			1						 1			1		1
1			111111     111111111111111			111111111
1									 1					1
1									 1					1
1			11111     1111111     111111   11111    11111111111111111111111111111
1																				1
1																				1
1																				1
1																				1
1																				1
1																				1
1																				1
1																				1
1																				1
1																				1
1																				1
1																				1
1																				1
1																				1
1																				1
1																				1
1																				1
1																				1
1																				1
1																				1
1																				1
1																				1
1																				1
1																				1
1																				1
1																				1
1																				1
1																				1
1																				1
1																				1
1																				1
1																				1
1																				1
1																				1
1																				1
1																				1
1																				1
1																				1
1																				1
1																				1
1																				1
1																				1
1																				1
1																				1
1																				1
1																				1
1																				1
1																				1
1																				1
1																				1
1																				1
1																				1
1																				1
1																				1
1																				1
1																				1
1																				1
1																				1
1																				1
1																				1
1																				1
1																				1
1																				1
1																				1
1																				1
1																				1
1																				1
1																				1
1																				1
1																				1
1																				1
1																				1
1																				1
1																				1
1																				1
1																				1
1																				1
111111111111111111111111111111111111111111111111111111111111111111111111111111111