NO textures/cub3d_tex/cat.xpm
SO textures/cub3d_tex/linh.xpm
WE textures/cub3d_tex/jen.xpm
EA textures/cub3d_tex/cube.xpm

F 18,53,25
C 153,204,255
111111
100101
101011
101E01
100001
111111